[
  {
    "x": 200,
    "y": 500,
    "w": 100,
    "h": 20
  },
  {
    "x": 300,
    "y": 400,
    "w": 100,
    "h": 20
  },
  {
    "x": 400,
    "y": 300,
    "w": 100,
    "h": 20
  }
]